R 720 480

NO ./texture/colorstone.xpm
SO ./texture/eagle.xpm
WE ./texture/mossy.xpm
EA ./texture/bluestone.xpm

S ./texture/monstre.xpm

C 255,0,0
F 0, 255, 0
1111111111111
1010101101011
1010101101011
1N00000000001
1000000000001
1111111111111
